#####@####################################
#####.####################################
#####.####################################
#####.#######......#######################
#####.#######.####.#######################
#####.####.##.####.#######################
#####.&.......####.#######################
##################.#######################
##################.#######################
##################.#######################
#########.........&#######################
#########&########&#######################
#########.########&#######################
#########.###........#####################
#########.....######.#####################
#########.##########.#####################
####################.#####################
####################.#####################
############.........#####################
############.#############################
############.#################...#########
############...................f.#########
##############################...#########
