###################....###########
###################.##.###########
###################.##.###########
##############...##.##.###########
##############.#....##...........#
##############...###########......
###############.##########........
###############.##.........####...
###############.##.############&&.
###############....############.&&
#################.##############..
##########....###.#############...
##########.##.....#############&&.
#...######.####################..&
#.f........###########.########...
#...##################....&&......
######################.###########
######################&###########
######################.###########
######################.###########
######################.....#######
##########################.#######
##########################.#######
##########################.#######
#########################..#######
#########################.########
#########################.########
#########################.########
########################...#######
########################.@.#######
########################...#######