.........................
...#.....................
...##......#####....#....
...#######.#...#....#....
...######..#.#.#...###...
.###.##....#.#.#...###...
.###.##..###.#.#...###...
.#...##.....&&.#.........
###..##..###.#.###.......
.#...@.......#...........
.............#####.......